111111111111111
100S00000000C01
10PESC0000C0S01
1C0CC0000000C01
1C0CC0000000C01
1C0CC00S00E0C01
1C0CC0000000C01
111111111111111