11111111111
10000000C01
10PE0C0C001
1C0CC000C01
11111111111