1111111
10000C1
1PEC001
1111111